{
  "header": "ZeldaMap",
  "name": "level1",
  "screenData": [
    [
      null,
      null,
      null,
      null,
      null,
      null
    ],
    [
      null,
      null,
      null,
      null,
      null,
      null
    ],
    [
      null,
      null,
      null,
      null,
      null,
      null
    ],
    [
      null,
      null,
      null,
      null,
      null,
      null
    ],
    [
      null,
      null,
      null,
      null,
      null,
      null
    ],
    [
      null,
      {
        "tiles": [ [ 12, 13, 0, 1, 2, 3, 4, 5, 6, 7, 8, 9, 10, 11, 14, 15 ],
          [ 28, 29, 16, 17, 18, 19, 20, 21, 22, 23, 24, 25, 26, 26, 30, 31 ],
          [ 44, 45, 118, 118, 118, 118, 118, 118, 118, 118, 118, 118, 118, 118, 46, 47 ],
          [ 60, 61, 118, 118, 118, 118, 118, 118, 118, 118, 118, 118, 118, 118, 62, 63 ],
          [ 76, 77, 118, 118, 118, 118, 118, 118, 118, 118, 118, 118, 118, 118, 64, 65 ],
          [ 92, 93, 118, 118, 118, 118, 118, 118, 118, 118, 118, 118, 118, 118, 80, 81 ],
          [ 108, 109, 118, 118, 118, 118, 118, 118, 118, 118, 118, 118, 118, 118, 96, 97 ],
          [ 124, 125, 118, 118, 118, 118, 118, 118, 118, 118, 118, 118, 118, 118, 126, 127 ],
          [ 140, 141, 118, 118, 118, 118, 118, 118, 118, 118, 118, 118, 118, 118, 142, 143 ],
          [ 156, 157, 32, 33, 34, 35, 36, 37, 38, 39, 40, 41, 42, 43, 158, 159 ],
          [ 172, 173, 48, 49, 50, 51, 52, 53, 54, 55, 56, 57, 58, 59, 174, 175 ] ],
        "enemyGroup": {
          "spawnStyle": "random",
          "enemies": []
        }
      },
      {
        "tiles": [ [ 12, 13, 0, 1, 2, 3, 4, 5, 6, 7, 8, 9, 10, 11, 14, 15 ],
          [ 28, 29, 16, 17, 18, 19, 20, 21, 22, 23, 24, 25, 26, 26, 30, 31 ],
          [ 44, 45, 118, 118, 118, 118, 118, 118, 118, 118, 118, 118, 118, 118, 46, 47 ],
          [ 60, 61, 118, 151, 118, 118, 151, 118, 118, 152, 118, 118, 152, 118, 62, 63 ],
          [ 70, 71, 118, 118, 118, 118, 118, 118, 118, 118, 118, 118, 118, 118, 64, 65 ],
          [ 86, 87, 118, 151, 118, 118, 151, 118, 118, 152, 118, 118, 152, 118, 80, 81 ],
          [ 102, 103, 118, 118, 118, 118, 118, 150, 150, 118, 118, 118, 118, 118, 96, 97 ],
          [ 124, 125, 118, 151, 118, 150, 151, 150, 150, 152, 150, 118, 152, 118, 126, 127 ],
          [ 140, 141, 118, 118, 118, 150, 150, 150, 150, 150, 150, 118, 118, 118, 142, 143 ],
          [ 156, 157, 32, 33, 34, 35, 36, 144, 145, 39, 40, 41, 42, 43, 158, 159 ],
          [ 172, 173, 48, 49, 50, 51, 52, 160, 161, 55, 56, 57, 58, 59, 174, 175 ] ],
        "enemyGroup": {
          "spawnStyle": "random",
          "enemies": []
        },
        "events": [
          {
            "type": "changeScreenWarp",
            "tile": {
              "row": 0,
              "col": 0
            },
            "animate": true,
            "destMap": "overworld",
            "destScreen": {
              "row": 3,
              "col": 6
            },
            "destPos": {
              "row": 4,
              "col": 7
            }
          }
        ]
      },
      {
        "tiles": [ [ 12, 13, 0, 1, 2, 3, 4, 5, 6, 7, 8, 9, 10, 11, 14, 15 ],
          [ 28, 29, 16, 17, 18, 19, 20, 21, 22, 23, 24, 25, 26, 26, 30, 31 ],
          [ 44, 45, 118, 118, 118, 118, 118, 118, 118, 118, 118, 118, 118, 118, 46, 47 ],
          [ 60, 61, 118, 118, 118, 118, 118, 118, 118, 118, 118, 118, 118, 118, 62, 63 ],
          [ 70, 71, 118, 118, 139, 139, 118, 118, 118, 118, 139, 139, 118, 118, 78, 79 ],
          [ 86, 87, 118, 118, 139, 139, 118, 118, 118, 118, 139, 139, 118, 118, 94, 95 ],
          [ 102, 103, 118, 118, 139, 139, 118, 118, 118, 118, 139, 139, 118, 118, 110, 111 ],
          [ 124, 125, 118, 118, 118, 118, 118, 118, 118, 118, 118, 118, 118, 118, 126, 127 ],
          [ 140, 141, 118, 118, 118, 118, 118, 118, 118, 118, 118, 118, 118, 118, 142, 143 ],
          [ 156, 157, 32, 33, 34, 35, 36, 37, 38, 39, 40, 41, 42, 43, 158, 159 ],
          [ 172, 173, 48, 49, 50, 51, 52, 53, 54, 55, 56, 57, 58, 59, 174, 175 ] ],
        "enemyGroup": {
          "spawnStyle": "random",
          "enemies": []
        }
      },
      null,
      null
    ]
  ],
  "tilesetData": {
    "name": "labyrinths"
  },
  "music": "labyrinthMusic",
  "row": 5,
  "col": 2
}