{
  "header": "ZeldaMap",
  "name": "level1",
  "screenData": [
    [
      {
        "tiles": [ [ 12, 13, 0, 1, 2, 3, 4, 5, 6, 7, 8, 9, 10, 11, 14, 15 ],
          [ 28, 29, 16, 17, 18, 19, 20, 21, 22, 23, 24, 25, 26, 26, 30, 31 ],
          [ 44, 45, 102, 102, 102, 102, 102, 102, 102, 102, 102, 102, 102, 102, 46, 47 ],
          [ 60, 61, 102, 102, 102, 102, 102, 102, 102, 102, 102, 102, 102, 102, 62, 63 ],
          [ 76, 77, 102, 102, 102, 102, 102, 102, 102, 102, 102, 102, 102, 102, 78, 79 ],
          [ 92, 93, 102, 102, 102, 102, 102, 102, 102, 102, 102, 102, 102, 102, 94, 95 ],
          [ 108, 109, 102, 102, 102, 102, 102, 102, 102, 102, 102, 102, 102, 102, 110, 111 ],
          [ 124, 125, 102, 102, 102, 102, 102, 102, 102, 102, 102, 102, 102, 102, 126, 127 ],
          [ 140, 141, 102, 102, 102, 102, 102, 102, 102, 102, 102, 102, 102, 102, 142, 143 ],
          [ 156, 157, 32, 33, 34, 35, 36, 37, 38, 39, 40, 41, 42, 43, 158, 159 ],
          [ 172, 173, 48, 49, 50, 51, 52, 53, 54, 55, 56, 57, 58, 59, 174, 175 ] ],
        "enemyGroup": {
          "spawnStyle": "random",
          "enemies": []
        }
      },
      {
        "tiles": [ [ 12, 13, 0, 1, 2, 3, 4, 5, 6, 7, 8, 9, 10, 11, 14, 15 ],
          [ 28, 29, 16, 17, 18, 19, 20, 21, 22, 23, 24, 25, 26, 26, 30, 31 ],
          [ 44, 45, 102, 102, 102, 102, 102, 102, 102, 102, 102, 102, 102, 102, 46, 47 ],
          [ 60, 61, 102, 102, 102, 102, 102, 102, 102, 102, 102, 102, 102, 102, 62, 63 ],
          [ 76, 77, 102, 102, 102, 102, 102, 102, 102, 102, 102, 102, 102, 102, 78, 79 ],
          [ 92, 93, 102, 102, 102, 102, 102, 102, 102, 102, 102, 102, 102, 102, 94, 95 ],
          [ 108, 109, 102, 102, 102, 102, 102, 102, 102, 102, 102, 102, 102, 102, 110, 111 ],
          [ 124, 125, 102, 102, 102, 102, 102, 102, 102, 102, 102, 102, 102, 102, 126, 127 ],
          [ 140, 141, 102, 102, 102, 102, 102, 102, 102, 102, 102, 102, 102, 102, 142, 143 ],
          [ 156, 157, 32, 33, 34, 35, 36, 37, 38, 39, 40, 41, 42, 43, 158, 159 ],
          [ 172, 173, 48, 49, 50, 51, 52, 53, 54, 55, 56, 57, 58, 59, 174, 175 ] ],
        "enemyGroup": {
          "spawnStyle": "random",
          "enemies": []
        }
      },
      {
        "tiles": [ [ 12, 13, 0, 1, 2, 3, 4, 5, 6, 7, 8, 9, 10, 11, 14, 15 ],
          [ 28, 29, 16, 17, 18, 19, 20, 21, 22, 23, 24, 25, 26, 26, 30, 31 ],
          [ 44, 45, 102, 102, 102, 102, 102, 102, 102, 102, 102, 102, 102, 102, 46, 47 ],
          [ 60, 61, 102, 102, 102, 102, 102, 102, 102, 102, 102, 102, 102, 102, 62, 63 ],
          [ 76, 77, 102, 102, 102, 102, 102, 102, 102, 102, 102, 102, 102, 102, 78, 79 ],
          [ 92, 93, 102, 102, 102, 102, 102, 102, 102, 102, 102, 102, 102, 102, 94, 95 ],
          [ 108, 109, 102, 102, 102, 102, 102, 102, 102, 102, 102, 102, 102, 102, 110, 111 ],
          [ 124, 125, 102, 102, 102, 102, 102, 102, 102, 102, 102, 102, 102, 102, 126, 127 ],
          [ 140, 141, 102, 102, 102, 102, 102, 102, 102, 102, 102, 102, 102, 102, 142, 143 ],
          [ 156, 157, 32, 33, 34, 35, 36, 37, 38, 39, 40, 41, 42, 43, 158, 159 ],
          [ 172, 173, 48, 49, 50, 51, 52, 53, 54, 55, 56, 57, 58, 59, 174, 175 ] ],
        "enemyGroup": {
          "spawnStyle": "random",
          "enemies": []
        }
      },
      {
        "tiles": [ [ 12, 13, 0, 1, 2, 3, 4, 5, 6, 7, 8, 9, 10, 11, 14, 15 ],
          [ 28, 29, 16, 17, 18, 19, 20, 21, 22, 23, 24, 25, 26, 26, 30, 31 ],
          [ 44, 45, 102, 102, 102, 102, 102, 102, 102, 102, 102, 102, 102, 102, 46, 47 ],
          [ 60, 61, 102, 102, 102, 102, 102, 102, 102, 102, 102, 102, 102, 102, 62, 63 ],
          [ 76, 77, 102, 102, 102, 102, 102, 102, 102, 102, 102, 102, 102, 102, 78, 79 ],
          [ 92, 93, 102, 102, 102, 102, 102, 102, 102, 102, 102, 102, 102, 102, 94, 95 ],
          [ 108, 109, 102, 102, 102, 102, 102, 102, 102, 102, 102, 102, 102, 102, 110, 111 ],
          [ 124, 125, 102, 102, 102, 102, 102, 102, 102, 102, 102, 102, 102, 102, 126, 127 ],
          [ 140, 141, 102, 102, 102, 102, 102, 102, 102, 102, 102, 102, 102, 102, 142, 143 ],
          [ 156, 157, 32, 33, 34, 35, 36, 37, 38, 39, 40, 41, 42, 43, 158, 159 ],
          [ 172, 173, 48, 49, 50, 51, 52, 53, 54, 55, 56, 57, 58, 59, 174, 175 ] ],
        "enemyGroup": {
          "spawnStyle": "random",
          "enemies": []
        }
      },
      {
        "tiles": [ [ 12, 13, 0, 1, 2, 3, 4, 5, 6, 7, 8, 9, 10, 11, 14, 15 ],
          [ 28, 29, 16, 17, 18, 19, 20, 21, 22, 23, 24, 25, 26, 26, 30, 31 ],
          [ 44, 45, 102, 102, 102, 102, 102, 102, 102, 102, 102, 102, 102, 102, 46, 47 ],
          [ 60, 61, 102, 102, 102, 102, 102, 102, 102, 102, 102, 102, 102, 102, 62, 63 ],
          [ 76, 77, 102, 102, 102, 102, 102, 102, 102, 102, 102, 102, 102, 102, 78, 79 ],
          [ 92, 93, 102, 102, 102, 102, 102, 102, 102, 102, 102, 102, 102, 102, 94, 95 ],
          [ 108, 109, 102, 102, 102, 102, 102, 102, 102, 102, 102, 102, 102, 102, 110, 111 ],
          [ 124, 125, 102, 102, 102, 102, 102, 102, 102, 102, 102, 102, 102, 102, 126, 127 ],
          [ 140, 141, 102, 102, 102, 102, 102, 102, 102, 102, 102, 102, 102, 102, 142, 143 ],
          [ 156, 157, 32, 33, 34, 35, 36, 37, 38, 39, 40, 41, 42, 43, 158, 159 ],
          [ 172, 173, 48, 49, 50, 51, 52, 53, 54, 55, 56, 57, 58, 59, 174, 175 ] ],
        "enemyGroup": {
          "spawnStyle": "random",
          "enemies": []
        }
      },
      {
        "tiles": [ [ 12, 13, 0, 1, 2, 3, 4, 5, 6, 7, 8, 9, 10, 11, 14, 15 ],
          [ 28, 29, 16, 17, 18, 19, 20, 21, 22, 23, 24, 25, 26, 26, 30, 31 ],
          [ 44, 45, 102, 102, 102, 102, 102, 102, 102, 102, 102, 102, 102, 102, 46, 47 ],
          [ 60, 61, 102, 102, 102, 102, 102, 102, 102, 102, 102, 102, 102, 102, 62, 63 ],
          [ 76, 77, 102, 102, 102, 102, 102, 102, 102, 102, 102, 102, 102, 102, 78, 79 ],
          [ 92, 93, 102, 102, 102, 102, 102, 102, 102, 102, 102, 102, 102, 102, 94, 95 ],
          [ 108, 109, 102, 102, 102, 102, 102, 102, 102, 102, 102, 102, 102, 102, 110, 111 ],
          [ 124, 125, 102, 102, 102, 102, 102, 102, 102, 102, 102, 102, 102, 102, 126, 127 ],
          [ 140, 141, 102, 102, 102, 102, 102, 102, 102, 102, 102, 102, 102, 102, 142, 143 ],
          [ 156, 157, 32, 33, 34, 35, 36, 37, 38, 39, 40, 41, 42, 43, 158, 159 ],
          [ 172, 173, 48, 49, 50, 51, 52, 53, 54, 55, 56, 57, 58, 59, 174, 175 ] ],
        "enemyGroup": {
          "spawnStyle": "random",
          "enemies": []
        }
      },
      {
        "tiles": [ [ 12, 13, 0, 1, 2, 3, 4, 5, 6, 7, 8, 9, 10, 11, 14, 15 ],
          [ 28, 29, 16, 17, 18, 19, 20, 21, 22, 23, 24, 25, 26, 26, 30, 31 ],
          [ 44, 45, 102, 102, 102, 102, 102, 102, 102, 102, 102, 102, 102, 102, 46, 47 ],
          [ 60, 61, 102, 102, 102, 102, 102, 102, 102, 102, 102, 102, 102, 102, 62, 63 ],
          [ 76, 77, 102, 102, 102, 102, 102, 102, 102, 102, 102, 102, 102, 102, 78, 79 ],
          [ 92, 93, 102, 102, 102, 102, 102, 102, 102, 102, 102, 102, 102, 102, 94, 95 ],
          [ 108, 109, 102, 102, 102, 102, 102, 102, 102, 102, 102, 102, 102, 102, 110, 111 ],
          [ 124, 125, 102, 102, 102, 102, 102, 102, 102, 102, 102, 102, 102, 102, 126, 127 ],
          [ 140, 141, 102, 102, 102, 102, 102, 102, 102, 102, 102, 102, 102, 102, 142, 143 ],
          [ 156, 157, 32, 33, 34, 35, 36, 37, 38, 39, 40, 41, 42, 43, 158, 159 ],
          [ 172, 173, 48, 49, 50, 51, 52, 53, 54, 55, 56, 57, 58, 59, 174, 175 ] ],
        "enemyGroup": {
          "spawnStyle": "random",
          "enemies": []
        }
      },
      {
        "tiles": [ [ 12, 13, 0, 1, 2, 3, 4, 5, 6, 7, 8, 9, 10, 11, 14, 15 ],
          [ 28, 29, 16, 17, 18, 19, 20, 21, 22, 23, 24, 25, 26, 26, 30, 31 ],
          [ 44, 45, 102, 102, 102, 102, 102, 102, 102, 102, 102, 102, 102, 102, 46, 47 ],
          [ 60, 61, 102, 102, 102, 102, 102, 102, 102, 102, 102, 102, 102, 102, 62, 63 ],
          [ 76, 77, 102, 102, 102, 102, 102, 102, 102, 102, 102, 102, 102, 102, 78, 79 ],
          [ 92, 93, 102, 102, 102, 102, 102, 102, 102, 102, 102, 102, 102, 102, 94, 95 ],
          [ 108, 109, 102, 102, 102, 102, 102, 102, 102, 102, 102, 102, 102, 102, 110, 111 ],
          [ 124, 125, 102, 102, 102, 102, 102, 102, 102, 102, 102, 102, 102, 102, 126, 127 ],
          [ 140, 141, 102, 102, 102, 102, 102, 102, 102, 102, 102, 102, 102, 102, 142, 143 ],
          [ 156, 157, 32, 33, 34, 35, 36, 37, 38, 39, 40, 41, 42, 43, 158, 159 ],
          [ 172, 173, 48, 49, 50, 51, 52, 53, 54, 55, 56, 57, 58, 59, 174, 175 ] ],
        "enemyGroup": {
          "spawnStyle": "random",
          "enemies": []
        }
      },
      {
        "tiles": [ [ 12, 13, 0, 1, 2, 3, 4, 5, 6, 7, 8, 9, 10, 11, 14, 15 ],
          [ 28, 29, 16, 17, 18, 19, 20, 21, 22, 23, 24, 25, 26, 26, 30, 31 ],
          [ 44, 45, 102, 102, 102, 102, 102, 102, 102, 102, 102, 102, 102, 102, 46, 47 ],
          [ 60, 61, 102, 102, 102, 102, 102, 102, 102, 102, 102, 102, 102, 102, 62, 63 ],
          [ 76, 77, 102, 102, 102, 102, 102, 102, 102, 102, 102, 102, 102, 102, 78, 79 ],
          [ 92, 93, 102, 102, 102, 102, 102, 102, 102, 102, 102, 102, 102, 102, 94, 95 ],
          [ 108, 109, 102, 102, 102, 102, 102, 102, 102, 102, 102, 102, 102, 102, 110, 111 ],
          [ 124, 125, 102, 102, 102, 102, 102, 102, 102, 102, 102, 102, 102, 102, 126, 127 ],
          [ 140, 141, 102, 102, 102, 102, 102, 102, 102, 102, 102, 102, 102, 102, 142, 143 ],
          [ 156, 157, 32, 33, 34, 35, 36, 37, 38, 39, 40, 41, 42, 43, 158, 159 ],
          [ 172, 173, 48, 49, 50, 51, 52, 53, 54, 55, 56, 57, 58, 59, 174, 175 ] ],
        "enemyGroup": {
          "spawnStyle": "random",
          "enemies": []
        }
      },
      {
        "tiles": [ [ 12, 13, 0, 1, 2, 3, 4, 5, 6, 7, 8, 9, 10, 11, 14, 15 ],
          [ 28, 29, 16, 17, 18, 19, 20, 21, 22, 23, 24, 25, 26, 26, 30, 31 ],
          [ 44, 45, 102, 102, 102, 102, 102, 102, 102, 102, 102, 102, 102, 102, 46, 47 ],
          [ 60, 61, 102, 102, 102, 102, 102, 102, 102, 102, 102, 102, 102, 102, 62, 63 ],
          [ 76, 77, 102, 102, 102, 102, 102, 102, 102, 102, 102, 102, 102, 102, 78, 79 ],
          [ 92, 93, 102, 102, 102, 102, 102, 102, 102, 102, 102, 102, 102, 102, 94, 95 ],
          [ 108, 109, 102, 102, 102, 102, 102, 102, 102, 102, 102, 102, 102, 102, 110, 111 ],
          [ 124, 125, 102, 102, 102, 102, 102, 102, 102, 102, 102, 102, 102, 102, 126, 127 ],
          [ 140, 141, 102, 102, 102, 102, 102, 102, 102, 102, 102, 102, 102, 102, 142, 143 ],
          [ 156, 157, 32, 33, 34, 35, 36, 37, 38, 39, 40, 41, 42, 43, 158, 159 ],
          [ 172, 173, 48, 49, 50, 51, 52, 53, 54, 55, 56, 57, 58, 59, 174, 175 ] ],
        "enemyGroup": {
          "spawnStyle": "random",
          "enemies": []
        }
      },
      {
        "tiles": [ [ 12, 13, 0, 1, 2, 3, 4, 5, 6, 7, 8, 9, 10, 11, 14, 15 ],
          [ 28, 29, 16, 17, 18, 19, 20, 21, 22, 23, 24, 25, 26, 26, 30, 31 ],
          [ 44, 45, 102, 102, 102, 102, 102, 102, 102, 102, 102, 102, 102, 102, 46, 47 ],
          [ 60, 61, 102, 102, 102, 102, 102, 102, 102, 102, 102, 102, 102, 102, 62, 63 ],
          [ 76, 77, 102, 102, 102, 102, 102, 102, 102, 102, 102, 102, 102, 102, 78, 79 ],
          [ 92, 93, 102, 102, 102, 102, 102, 102, 102, 102, 102, 102, 102, 102, 94, 95 ],
          [ 108, 109, 102, 102, 102, 102, 102, 102, 102, 102, 102, 102, 102, 102, 110, 111 ],
          [ 124, 125, 102, 102, 102, 102, 102, 102, 102, 102, 102, 102, 102, 102, 126, 127 ],
          [ 140, 141, 102, 102, 102, 102, 102, 102, 102, 102, 102, 102, 102, 102, 142, 143 ],
          [ 156, 157, 32, 33, 34, 35, 36, 37, 38, 39, 40, 41, 42, 43, 158, 159 ],
          [ 172, 173, 48, 49, 50, 51, 52, 53, 54, 55, 56, 57, 58, 59, 174, 175 ] ],
        "enemyGroup": {
          "spawnStyle": "random",
          "enemies": []
        }
      },
      {
        "tiles": [ [ 12, 13, 0, 1, 2, 3, 4, 5, 6, 7, 8, 9, 10, 11, 14, 15 ],
          [ 28, 29, 16, 17, 18, 19, 20, 21, 22, 23, 24, 25, 26, 26, 30, 31 ],
          [ 44, 45, 102, 102, 102, 102, 102, 102, 102, 102, 102, 102, 102, 102, 46, 47 ],
          [ 60, 61, 102, 102, 102, 102, 102, 102, 102, 102, 102, 102, 102, 102, 62, 63 ],
          [ 76, 77, 102, 102, 102, 102, 102, 102, 102, 102, 102, 102, 102, 102, 78, 79 ],
          [ 92, 93, 102, 102, 102, 102, 102, 102, 102, 102, 102, 102, 102, 102, 94, 95 ],
          [ 108, 109, 102, 102, 102, 102, 102, 102, 102, 102, 102, 102, 102, 102, 110, 111 ],
          [ 124, 125, 102, 102, 102, 102, 102, 102, 102, 102, 102, 102, 102, 102, 126, 127 ],
          [ 140, 141, 102, 102, 102, 102, 102, 102, 102, 102, 102, 102, 102, 102, 142, 143 ],
          [ 156, 157, 32, 33, 34, 35, 36, 37, 38, 39, 40, 41, 42, 43, 158, 159 ],
          [ 172, 173, 48, 49, 50, 51, 52, 53, 54, 55, 56, 57, 58, 59, 174, 175 ] ],
        "enemyGroup": {
          "spawnStyle": "random",
          "enemies": []
        }
      },
      {
        "tiles": [ [ 12, 13, 0, 1, 2, 3, 4, 5, 6, 7, 8, 9, 10, 11, 14, 15 ],
          [ 28, 29, 16, 17, 18, 19, 20, 21, 22, 23, 24, 25, 26, 26, 30, 31 ],
          [ 44, 45, 102, 102, 102, 102, 102, 102, 102, 102, 102, 102, 102, 102, 46, 47 ],
          [ 60, 61, 102, 102, 102, 102, 102, 102, 102, 102, 102, 102, 102, 102, 62, 63 ],
          [ 76, 77, 102, 102, 102, 102, 102, 102, 102, 102, 102, 102, 102, 102, 78, 79 ],
          [ 92, 93, 102, 102, 102, 102, 102, 102, 102, 102, 102, 102, 102, 102, 94, 95 ],
          [ 108, 109, 102, 102, 102, 102, 102, 102, 102, 102, 102, 102, 102, 102, 110, 111 ],
          [ 124, 125, 102, 102, 102, 102, 102, 102, 102, 102, 102, 102, 102, 102, 126, 127 ],
          [ 140, 141, 102, 102, 102, 102, 102, 102, 102, 102, 102, 102, 102, 102, 142, 143 ],
          [ 156, 157, 32, 33, 34, 35, 36, 37, 38, 39, 40, 41, 42, 43, 158, 159 ],
          [ 172, 173, 48, 49, 50, 51, 52, 53, 54, 55, 56, 57, 58, 59, 174, 175 ] ],
        "enemyGroup": {
          "spawnStyle": "random",
          "enemies": []
        }
      },
      {
        "tiles": [ [ 12, 13, 0, 1, 2, 3, 4, 5, 6, 7, 8, 9, 10, 11, 14, 15 ],
          [ 28, 29, 16, 17, 18, 19, 20, 21, 22, 23, 24, 25, 26, 26, 30, 31 ],
          [ 44, 45, 102, 102, 102, 102, 102, 102, 102, 102, 102, 102, 102, 102, 46, 47 ],
          [ 60, 61, 102, 102, 102, 102, 102, 102, 102, 102, 102, 102, 102, 102, 62, 63 ],
          [ 76, 77, 102, 102, 102, 102, 102, 102, 102, 102, 102, 102, 102, 102, 78, 79 ],
          [ 92, 93, 102, 102, 102, 102, 102, 102, 102, 102, 102, 102, 102, 102, 94, 95 ],
          [ 108, 109, 102, 102, 102, 102, 102, 102, 102, 102, 102, 102, 102, 102, 110, 111 ],
          [ 124, 125, 102, 102, 102, 102, 102, 102, 102, 102, 102, 102, 102, 102, 126, 127 ],
          [ 140, 141, 102, 102, 102, 102, 102, 102, 102, 102, 102, 102, 102, 102, 142, 143 ],
          [ 156, 157, 32, 33, 34, 35, 36, 37, 38, 39, 40, 41, 42, 43, 158, 159 ],
          [ 172, 173, 48, 49, 50, 51, 52, 53, 54, 55, 56, 57, 58, 59, 174, 175 ] ],
        "enemyGroup": {
          "spawnStyle": "random",
          "enemies": []
        }
      },
      {
        "tiles": [ [ 12, 13, 0, 1, 2, 3, 4, 5, 6, 7, 8, 9, 10, 11, 14, 15 ],
          [ 28, 29, 16, 17, 18, 19, 20, 21, 22, 23, 24, 25, 26, 26, 30, 31 ],
          [ 44, 45, 102, 102, 102, 102, 102, 102, 102, 102, 102, 102, 102, 102, 46, 47 ],
          [ 60, 61, 102, 102, 102, 102, 102, 102, 102, 102, 102, 102, 102, 102, 62, 63 ],
          [ 76, 77, 102, 102, 102, 102, 102, 102, 102, 102, 102, 102, 102, 102, 78, 79 ],
          [ 92, 93, 102, 102, 102, 102, 102, 102, 102, 102, 102, 102, 102, 102, 94, 95 ],
          [ 108, 109, 102, 102, 102, 102, 102, 102, 102, 102, 102, 102, 102, 102, 110, 111 ],
          [ 124, 125, 102, 102, 102, 102, 102, 102, 102, 102, 102, 102, 102, 102, 126, 127 ],
          [ 140, 141, 102, 102, 102, 102, 102, 102, 102, 102, 102, 102, 102, 102, 142, 143 ],
          [ 156, 157, 32, 33, 34, 35, 36, 37, 38, 39, 40, 41, 42, 43, 158, 159 ],
          [ 172, 173, 48, 49, 50, 51, 52, 53, 54, 55, 56, 57, 58, 59, 174, 175 ] ],
        "enemyGroup": {
          "spawnStyle": "random",
          "enemies": []
        }
      },
      {
        "tiles": [ [ 12, 13, 0, 1, 2, 3, 4, 5, 6, 7, 8, 9, 10, 11, 14, 15 ],
          [ 28, 29, 16, 17, 18, 19, 20, 21, 22, 23, 24, 25, 26, 26, 30, 31 ],
          [ 44, 45, 102, 102, 102, 102, 102, 102, 102, 102, 102, 102, 102, 102, 46, 47 ],
          [ 60, 61, 102, 102, 102, 102, 102, 102, 102, 102, 102, 102, 102, 102, 62, 63 ],
          [ 76, 77, 102, 102, 102, 102, 102, 102, 102, 102, 102, 102, 102, 102, 78, 79 ],
          [ 92, 93, 102, 102, 102, 102, 102, 102, 102, 102, 102, 102, 102, 102, 94, 95 ],
          [ 108, 109, 102, 102, 102, 102, 102, 102, 102, 102, 102, 102, 102, 102, 110, 111 ],
          [ 124, 125, 102, 102, 102, 102, 102, 102, 102, 102, 102, 102, 102, 102, 126, 127 ],
          [ 140, 141, 102, 102, 102, 102, 102, 102, 102, 102, 102, 102, 102, 102, 142, 143 ],
          [ 156, 157, 32, 33, 34, 35, 36, 37, 38, 39, 40, 41, 42, 43, 158, 159 ],
          [ 172, 173, 48, 49, 50, 51, 52, 53, 54, 55, 56, 57, 58, 59, 174, 175 ] ],
        "enemyGroup": {
          "spawnStyle": "random",
          "enemies": []
        }
      }
    ]
  ],
  "tilesetData": {
    "name": "labyrinths"
  },
  "music": "labyrinthMusic",
  "row": 0,
  "col": 0
}